############################
#************##************#
#*####*#####*##*#####*####*#
#*####*#####*##*#####*####*#
#*####*#####*##*#####*####*#
#**************************#
#*####*##*########*##*####*#
#*####*##*########*##*####*#
#******##****##****##******#
######*#####.##.#####*######
######*#####.##.#####*######
######*##..........##*######
######*##..........##*######
######*##.########.##*######
######*##.#......#.##*######
#.....*...#......#...*.....#
######*##.#......#.##*######
######*##.########.##*######
######*##..........##*######
######*##.########.##*######
######*##.########.##*######
#************##************#
#*####*#####*##*#####*####*#
#*####*#####*##*#####*####*#
#***##*******E********##***#
###*##*##*########*##*##*###
###*##*##*########*##*##*###
#******##****##****##******#
#*##########*##*##########*#
#*##########*##*##########*#
#**************************#
############################